0,7
7,0
b b b b w b b b
b b b b w b b b
w w b b w w b b
b b b b b w b b
b b b b b b b b
b b b b b b b w
b b b w b b w w
b b b w b b b b