7,7
0,0
b b b b b b b b
b b b b b b b b
b h w w w w w w
b b b b b b b b
w w w w w w h b
b b b b b b b b
b h w w w w w w
b b b b b b b b